mmmmmmmmmmmmmmmmmm
mmssssss000000000m
mssm0000000000000m
m0000000000000000m
m0000000000000000m
m0000000000000000m
m0000000000000000m
m000mmmmmmmm00000m
m0000000000000000m
m0000000000000000m
m0000000000000000m
m000000000000m0m0m
m000000000000m0m0m
m000000000000m0m0m
m000000000000m0m0m
m000000000000m0m0m
m000000000000m0m0m
m000000000000m0m0m
m0000000000000000m
m0000000000000000m
m0000000000000000m
m0000000000000000m
m0000000000000000m
m0000000000000000m
m0000000000000000m
m0000000000000000m
m0000000000000000m
m0000000000000000m
m0000000000000000m
m00m000000000000mm
m000000m0000m0000m
mmmmmmmmmmmmmmmmmm