mmmmmmmmmm
mm0000000m
m00m00000m
m00000000m
m0000m0m0m
m00000000m
m00000000m
m00m0000mm
m000000mmm
mmmmmmmmmm